###########
##       ##
#         #
#   ###  ##
#   ###  ##
#   #    ##
# ^ #######
#   ##    #
#      G  #
###########
